####################
#  vVVvYyXGgUuUu   #
#yr     u y     vu #
#gu u V y b U y ugu#
# U yWgyw ybguu  V #
# U u   Y W    u Vy#
# G wr bw uUrWWv V #
#by r U b v V  u yv#
# vy  y Yvu Y vvv u#
#u V           YY u#
# uuuuuuuuuuuuuuuu #
####################
