####################
#######   ##########
####### B  #########
######## W  ########
######### B  #######
########## W  ######
########### B  #####
############ W  ####
############# B  ###
######   ##### W ###
###X             ###
####################
