####################
#  #################
#  U V U V U V U   #
#                  #
#################B##
#                  #
#XY W Y W Y W Y W  #
#################R##
#                  #
# Y G B G B G B G  #
#################  #
####################
