####################
##    #    #    #  #
#  V#    #    #    #
# #  G #  B #    # #
#   R#W  R#    #   #
# W#  Y #XY  #    ##
##   B#  UV#GW  #  #
# Y #  GR# R  #U   #
# #    # B  #    # #
#    # U  #    # B #
#  #    #    #    ##
####################
