####################
#                X##
# #W#B#R#G#U#V#Y####
#                 ##
###V#Y#W#B#R#G#U# ##
#                 ##
# #G#U#V#Y#W#B#R####
#                 ##
###B#R#G#U#V#Y#W# ##
#                 ##
####################
####################
