####################
#b  #        #    b#
# WW  VWVVBr  V R# #
# R# VGGVu#gV# YRR #
#u  V bG   # V  Y ##
# YV  b# V  r V# R##
# V  Yb UUg#r  V  ##
# V # u BUUU  Y V  #
# G ##BBB B U # vug#
# V    B W B u # W #
#bVVV W WXw B U v  #
####################
