####################
####################
############ #######
######y     y#######
###### ##### #######
######b RX   #######
###### #####b#######
######y      #######
############b#######
####################
####################
####################
