####################
####################
##                 #
## #R# # # # #U#U# #
##    B u W b U b  #
## # # # # # # # # #
##  R v B g W W U  #
## # # # # # # # # #
##  R R v B v W U U#
## # # # # # # # # #
##  y b B u B w W X#
####################