####################
#                 ##
# #G#U#R#G#U#V#U# ##
# Y             B ##
# # ########### # ##
# R # # # # # # B ##
# # ########### # ##
# U             G ##
# #Y#B#Y#R#B#V#Y# ##
#X                ##
####################
####################
