####################
##     #     #     #
## ### # ### # ### #
##  V  #     #     #
##  #     #  W  #  #
###U# ###B#R### # ##
##  #  W  #  G  #  #
##  Y  #  X  #  B  #
## ###G#R###U#V### #
##     #     #     #
##  #     #     #  #
####################
