####################
#w    wwww www   ww#
#wURGBBBBBbBBBBGRU #
#wURGBYYYYYYYYBGRUw#
#wURGBYRBBGGRYBGRUw#
#wURGBYY  R BYBGRUw#
#wURGXYBURUBYYBGRUw#
#wURGBYYYYYYYYBGRUw#
#wURGBBBBBBBBBBGRUw#
#wURGGGGGGGGGGGGRUw#
# w  wwwwwwwwww   w#
####################
