####################
####################
#######u y#y u######
######u Y b Y u#####
###### Y B B Y #####
######y B V B y#####
#######b VXV b######
######y B V B y#####
###### Y B B Y #####
######u Y b Y u#####
#######u y#y u######
####################