####################
####################
##########   #   ###
########## #W# # ###
####X      B   u ###
#### ####### #######
####      ##   #####
######### ##B# #####
####      ##   #####
#### ####### #######
####       B   u ###
####################