####################
####################
######       #######
######wwwwwww#######
######ww   ww#######
# U V w ww  w U V ##
#     w wXw w     ##
# U V w  ww w U V ##
######ww   ww#######
######wwwwwww#######
######       #######
####################
