####################
#wbrgwbrgwbrgwbrgwb#
#  V W B R         #
#   V W B R        #
#    V W B R       #
#     V WXB R      #
#      V W B R     #
#       V W B R    #
#        V W B R   #
#         V W B R  #
#wbrgwbrgwbrgwbrgwb#
####################