####################
##       #       ###
## ##V##BWB##V## ###
##   U   #   U   ###
## # # # # # # # ###
#    #   V X #    ##
# ##RUY##G##RUY## ##
#    #   B   #    ##
##G# # # #Y# # #G###
##   V   #   V   ###
########   #########
####################
