####################
####################
####################
#####          #####
#####  G U V Y #####
##### R W B R  #####
#####  V Y G U #####
##### W B R G  #####
####X  W Y U V #####
####################
####################
####################