####################
####################
#####           ####
##### W U V Y W ####
#####  G B G B  ####
##### W Y R U W ####
#####  R VXV R  ####
##### W U R Y W ####
#####  B G B G  ####
##### W Y V U W ####
#####           ####
####################