####################
#        X        ##
# # # # # # # # # ##
#  G g V v B b U  ##
# # # # # # # # # ##
#  u B G UU YY B  ##
# # # # # # # # # ##
#  W R U B V Y B  ##
# # # # # # # # # ##
#                 ##
####################
####################
