####################
#####   ############
##### W  ###########
###### B  ##########
####### R  #########
######## G   #######
######### W  #######
########## B  ######
########### R  #####
############ G #####
#X             #####
####################
