####################
#  u#y  y#       #v#
# #rw ##bYbR B V #v#
#g##w# w######## #v#
#w yby gW       w#v#
###  gr####### # #v#
#w gu  B # bw#g# #v#
# # X# # # # # by#v#
# #  # # gr# #     #
# bR # b###wb##Y## #
#u#  #bw    w#  u g#
####################
