####################
####################
#########  #########
######  gY B r  ####
###### W #wu# U ####
######brg    bvr####
######     X    ####
######uyb    ggu####
###### G #uw# R ####
######  b V Wy  ####
###########  #######
####################
