####################
#y v####   #     ###
# U UU #B UU #WY   #
# GW     U     G U #
# Y  #URW#w   ######
# RGGrGRGrG##      #
# RV      Y #      #
#BG YyYyYY  # #### #
#    Y     B UB  B #
#WYYW  B WBRRBBWBB #
#XYY  VuUU    b   u#
####################