####################
####################
####################
####################
####################
#  g g g g g g gggg#
# Gg g g g g g gXgg#
####################
####################
####################
####################
####################