####################
####################
#####   #####   ####
####  WW       B ###
###  W      G     ##
###  W    X G     ##
###     V     V   ##
###     VG    V   ##
####           B ###
#####   #####   ####
####################
####################
