####################
############  ######
############   #####
############    ####
##            U  ###
###  R      X     ##
###      R        ##
##               ###
############    ####
############   #####
############  ######
####################
