####################
#####         ######
##### #R# #G# ######
##### U Y Y U ######
##### #R#V#G# ######
#####   VXV   ######
##### #G#V#R# ######
##### Y U U Y ######
##### #G# #R# ######
#####         ######
####################
####################
