####################
########   #########
#####    V #########
#####Y##   #########
####   ##V##   #####
#### Y Y X U U #####
####   ##W##   #####
########   ## ######
######## W  W ######
########   #########
####################
####################