####################
#  #    #     ######
#   # B  # U   #####
# Y  # G  # Y   ####
## U  # V  # R   ###
# # R  # B  # U   ##
#  # Y  # G  # Y   #
# G # U  # V  # R  #
#  B # R  # B  # U #
##  V # Y  # G  #  #
#X                 #
####################
