####################
####################
#######   #   ######
###### VVgBgVV #####
###### V#gBg#V #####
###### gggBggg #####
#######BBBXBBB######
###### gggBggg #####
###### V#gBg#V #####
###### VVgBgVV #####
#######   #   ######
####################