####################
####################
#######       ######
###### r#UV#gv #####
###### g R   # #####
###### # wGrRB #####
###### W VXU W #####
###### RVuYy # #####
###### #   V b #####
###### wb#RG#u #####
#######       ######
####################