####################
#                 ##
# # # # # # # # # ##
# # R G # G Y # # ##
# # # # # # # # # ##
# # # U V B # R YX##
# # # # # # # # # ##
# W B # # # U V # ##
# # # # # # # # # ##
#                 ##
####################
####################
