####################
####################
####################
####################
####################
####################
######     X########
######vgru  ########
###### Y #  ########
######  vg  ########
####################
####################
