####################
####################
####################
####################
#######     X#######
#######vgru  #######
####### G #  #######
#######  vg  #######
####################
####################
####################
####################