####################
#Xr     g   g#r   b#
#W### # r### # u## #
#W  #u# #v   # # r #
#WGr# # # #y # # # #
#W### #g#b## # # # #
#W# b # # b v# #u#g#
#W# ##g # #### u g #
#WGw g  gr    v### #
#W#####u#######v#u #
#      r          w#
####################