####################
##X  B  B  B  B  r##
## ## ## ## ## ## ##
## ## ## ## ## ## ##
##R  W  G  G  U  w##
## ## ## ## ## ## ##
## ## ## ## ## ## ##
##R  W  G  G  U  v##
## ## ## ## ## ## ##
## ## ## ## ## ## ##
##b  b  r  u  v  g##
####################
