####################
##########    ######
###    ###R##    ###
### ##     ## ## ###
### ## ##     ## ###
##    U## ## U   ###
## ## V   ##R##B   #
## ## ##  B  ## ## #
##  UV## ##   Y ## #
####XY   ## ###    #
########    ########
####################
