####################
#   B R GXU V Y   ##
# # # # # # # # # ##
# G U V Y B R G U ##
# # # # # # # # # ##
# V Y G U G U B R ##
# # # # # # # # # ##
# R G W B Y W U V ##
# # # # # # # # # ##
#wWwWwWwWwWwWwWwWw##
#                 ##
####################
