####################
####################
####################
####################
########r ##########
###### rrr##########
######rr rr#########
#######RXr #########
#######rr###########
####################
####################
####################
