####################
####################
#####     ##########
##### #U# ##########
#####       ########
#######V#R# ########
#######       ######
#########G#B# ######
#########       ####
###########Y#W# ####
###########    X####
####################
