####################
####################
##   #         #   #
## # # #B### # # # #
##   #   R   # #   #
## # # #Y###B# # # #
##   # # X     #   #
## # # #U###R# # # #
##   #   Y   # #   #
## # # #B### # # # #
##   #         #   #
####################