####################
##########    ######
######   W    ######
######   W    ######
######   W    ######
######  UWRRR#######
######RRRWU  #######
#####    W   #######
#####    W   #######
#####    W   #######
#####X   ###########
####################
