####################
####################
####################
## GuWgWXBuBwY #####
## # # #G# # # #####
## # # # # # # #####
##     y v     #####
#### #B# #W# #######
##  b   w   u  #####
####################
####################
####################
