####################
######       #######
#####   UUG   ######
#####   V R   ######
##### YBBRBYG ######
##### B GXB R ######
##### VGGGVRV ######
#####   B V   ######
#####   WBR   ######
######       #######
####################
####################
