####################
####################
####            ####
####  Y V U G R ####
#### U G U V Y  ####
####  R W B R V ####
#### B V Y G U  ####
####  W B R G G ####
#### R W Y U V  ####
###X            ####
####################
####################
