####################
######w w#w w#######
#####w Y B Y w######
##### Y#w w#Y ######
#####w w V w w######
######B VXV B#######
#####w w V w w######
##### Y#w w#Y ######
#####w Y B Y w######
######w w#w w#######
####################
####################
