####################
#  g ###    ### g  #
# g ###  WW  ### g #
#g ###  BBBB  ### g#
# ###  By##gB  ### #
####  Bv####rB  ####
###  Bu######bB  ###
##  B   yUwb   B  ##
#  BWWWwVUYYrWWWB  #
# B #####X###### B #
#  ##############  #
####################