####################
####################
######    #    #####
###### GGGbGGG #####
###### GRR RRG #####
###### GRBrBRG #####
#######r  X  u######
###### GRBgBRG #####
###### GRR RRG #####
###### GGGvGGG #####
######    #    #####
####################
